1111111111111111111111111111111111111111
10100101001000001010010000000E0101000011
1010010010101010001001000000010101000011
1P0000000C00C0000000000000000000C1000011
101001010010000010100100000000C0000C0011
1010010010101010001001000000010C01000011
10000000C00C0000000000000000000C000C0011
101001010010000010100100000000C0000C0011
1010010010101010001001000000010101000011
10000000C00C0000000000000000000C000C0011
101001010010000010100100000000C000C00011
1010010010101010001001000000010101000011
10000000C00C0000000000000000000C00C00011
101001010010000010100100000000C0100C0011
1010010010101010001001000000010101000011
10000000C00C0000000000000000000C00C00011
101001010010000010100100000000C000C00011
1010010010101010001001000000010101000011
10000000C00C0000000000000000000C000C0011
10000000C00C0000000000000000000C100C0011
1111111111111111111111111111111111111111
