11111111111111
10C00011C00C01
1P00001C001001
1E00C000100011
11111111111111
