1111111111111111111111111111111111111111
10100101001000001010010000000E0101000011
1010010010101010001001000000010101000011
1P0000000C00C0000000000000000000C1000011
1111111111111111111111111111111111111111
